10 10
...#..A.#.
....B...##
...#......
..........
...#.#....
..##..#...
.......#..
#.......#.
...#....#.
#......#..

